11111111111111111111111111111111111111111111111111111111111111111111111111111111111111111111111111111111111111111111111111111111111111111111
00000400000000040000000000000004000000000000000004000000000000000004000000000000000000004000000000000000000000000000000000000000000400000002
00000000004000000000004000000000004000000000000000000000040000000000000000000000000000000000000000000000040000000000000000000000000000000002
00000004000000004000000000000400000000000400040000000000000000000004000000000000000000000000000000000000000000000000000000000400000000040002
00000000000000000000000000000000400000400000000004000000400000000000000000004000000000000400000000000000004000000000000000000000000400000002
00000000004000000000000000000000000000000400000000000000004000000004000000000000000000000000000000000000000000000000000000000000000000000002
00000400000000000000000020000000000000000000000000000000000000000000000000000000000000000000000020000000000002002000200000000000000000000000
00000000000004000000000220000000000000000000000000000000000000000000000000000000000000000000020002000000022000000000002000000000000000000000
00000000000000000000002220000000000000000000000000000000000000000000000000000000000000000002000002002002022000000000000002000000000000000000
00000000000000000000022220002000022222222000222220022222200020002020020002002000200020002020000000000000022000000000000000222200222002222222
00000000000000000000222220000000000000000000000000000000000000002000000002000000000000000000000000000000022000000000000000000000000000000000
00000000000000000002222220000000000000000000000000000000000000002000000002000000000000000000000000000000022000000000000000000000000000000002
00000000000000000022222220000000000000000000000000000000000000002000000002000000000000000000000000000000022000000000000000000000000000000002
00000000000000000222222220000000000000000000000000000000000000002000000002000000000000000000000000000000022000000000000000000000000000000002
00000000000000022222222220000000000000000000000000000000000000002000000002000000000000000000000000000000022000000000000000000000000000000002
00000000000000222222222220000000000000000000000000000000000000002000000002000000000000000000000000000000022000000000000000000000000000000000
00000000000022222222222220000000000000000000000000000000000000002000000002000000000000000000000000000000022000000000000000000000000000000000
00000000002222222222222220000000000000000000000000000000000000000000000000000000000000000000000000000000000000000000000000000000000000000000
00000000222222222222222222020202020020200200200200200200002020000002020000000020020020020020002000020020000002002002000200002000020020000000
11111111111111111111111111111111111111111111111111111111111111111111111111111111111111111111111111111111111111111111111111111111111111111111