11111111111111111111111111111111111111111111111111111111111111111111111111111111111111111111111111111111111111111111111111111111111111111111
00000000000000000000000000000000000000000000000000000000000000000000000000000000000000000000000000000000000000000000000000000000000000000002
00000000000000000000000000000000000000000000000000000000000000000000000000000000000000000000000000000000000000000000000000000000000000000002
00000000000000000000000000000000000000000000000000000000000000000000000000000000000000000000000000000000000000000000000000000000000000000002
00000000000000000000000000000000000000000000000000000000000000000000000000000000000000000000000000000000000000000000000000000000000000000002
00000000000000000000000000000000000000000000000000000000000000000000000000000000000000000000000000000000000000000000000000000000000000000002
00000000000000000000000000000000000000000000000000000000000000000000000000000000000000000000000000000000000000000000000000000000000000000002
00000000000000000000000000000000000000000000000000000000000000000000000000000000000000000000000020000000000002002000200000000000000000000000
00000000000000000000000000000000000000000000000000000000000000000000000000000000000000000000200000000000002000000000002000000000000000000000
00000000000000000000000000000000000000000000000000000000000000000000000000000000000000000002000002002002000000000000000002000000000000000000
00000000000000000020200200020002020000000000000000000000000000000000000000000002000200020200000000000000000000000000000002222002220022222222
00000000000000020000000000000000022222222000000000000000000000000000000000002000000000000000000000000000000000000000000000000000000000000000
00000000000020000000000000000000000000000200000000000000000000000002000020200000000000000000000000000000000000000000000000000000000000000002
00000000020000000000000000000000000000000020002000002000020000200000000000000000000000000000000000000000000000000000000000000000000000000002
11111111111111111133333333333333333333311111333133333133331333311111111111111111111133331111113333111111111113333311111111113333333311111111