11111111111111111111111111111111111111111111111111111111111111111111111111111111111111111111111111111111111111111111111111111111111111111111
00000400000000040000000000000004000000000000000004000000000000000004000000000000000000004000000000000000000000000000000000000000000400000002
00000000004000000000004000000000004000000000000000000000040000000000000000000000000000000000000000000000040000000000000000000000000000000002
00000004000000004000000000000400000000000400040000000000000000000004000000000000000000000000000000000000000000000000000000000400000000040002
00000000000000000000000000000000400000400000000004000000400000000000000000004000000000000400000000000000004000000000000000000000000400000002
00000000004000000000000000000000000000000400000000000000004000000004000000000000000000000000000000000000000000000000000000000000000000000002
00000400000000000000000000000000000000000000000000000000000000000000000000000000000000000000000020000000000002002000200000000000000000000000
00000000000004000000000000000000000000000000000000000000000000000000000000000000000000000000020002000000002000000000002000000000000000000000
00000000000000000000000000000000000000000000000000000000000000000000000000000000000000000002000002002002000000000000000002000000000000000000
00000000000000000000022200002000022222222000222220022222200020002020020002002000200020002020000000000000000000000000000000222200222002222222
00000000000000000000200000000000000000000000000000000000000000002000000002000000000000000000000000000000000000000000000000000000000000000000
00000000000000000002000000000000000000000000000000000000000000002000000000000000000000000000000000000000000000000000000000000000000000000002
00000000000000000020000000000000000000000000000000000000000000002000000000000000000000000000000000000000000000000000000000000000000000000002
00000000000000000200000000000000000000000000000000000000000000002000000000000000000000000000000000000000000000000000000000000000000000000002
00000000000000020000000000000000000000000000000000000000000000002000000000000000000000000000000000000000000000000000000000000000000000000002
00000000000000200000000000000000000000000000000000000000000000002000000000000000000000000000000000000000000000000000000000000000000000000000
00000000000022000000000000000000000000000000000000000000000000002000000000000000000000000000000000000000020000000000000000000000000000000000
00000000002200000000000000000000000000000000000000000000000000000000000000000000000000000000000000000000000000000000000000000000000000000000
00000000220020200200002000202020202002020020020020020020000200002020202002002002002002002002000200002002002002000200200020000200002002000000
11111111111111111111111111111111111111111111111111111111111111111111111111111111111111111111111111111111111111111111111111111111111111111111