11111111111111111111111111111111111111111111111111111111111111111111111111111111111111111111111111111111111111111111111111111111111111111111
00000000000000000000000000000000000000000000000000000000000000000000000000000000000000000000000000000000000000000000000000000000000000000002
00000000000000000000000000000000000000000000000000000000000000000000000000000000000000000000000000000000000000000000000000000000000000000002
00000000000000000000000000000000000000000000000000000000000000000000000000000000000000000000000000000000000000000000000000000000000000000002
00000000000000000000000000000000000000000000000000000000000000000000000000000000000000000000000000000000000000000000000000000000000000000002
00000000000000000000000000000000000000000000000000000000000000000000000000000000000000000000000000000000000000000000000000000000000000000002
00000000000000000000000000000000000000000000000000000000000000000000000000000000000000000000000000000000000000000000000000000000000000000002
00000000000000000000000000000000000000000000000000000000000000000000000000000000000000000000000000000000000004000000000000000000000000000002
00000040000400000000000000000000000000000000000000000000000000000000000000000000000000000400000000000000000000000000000040000000000004000002
00004000400000000400000004000004000400000000040000000400000000400000000000000400000000000000000400000000000040000000000400000000000400000002
00404000040000000000000000000000040000000040040000000040000000000000000400000000040000000400000000000000000000000000000000000000000000000002
00400000000000000400000000004000000000000000000000040000000000004000000000000000000000000000000040000000000004004000400000000000000000000000
00000000000000000000000000000000000000000000000000000000000000000000000000000000000000000000404000000000004000000000000000000000000000000000
00000000000000000000000000000000000000000000000000000000000000000000000000000000000000000004000004004004000000000000000000000000000000000000
00000000000000000000000000000000000000000000000000000000000000000000000000000000000000000400000000000000000000000000000002222002220022222222
00000000000000000020200200020002000000000000000000000000000000000000000000020000020002022020202000000020000200002000002000000000000000000000
00000000000020020000000000000002222222222000000000000000000000000020000202000000000000000000000000200000000000000000000000000000000000000000
00000000002000000000000000000000000000000000000000000000000000002000000000000000000000000000000000000000000000000000000000000000000000000000
00000000020000000000000000000000000000000020002000002000020000222222000000000000000000000000000000000000000000000000000000000000000000000000
11111111111111111133333333333333333333311111331133331133311333111111111111111111111133331111113333111111111113333311111111113333133311111111