11111111111111111111111111111111111111111111111111111111111111111111111111111111111111111111111111111111111111111111111111111111111111111111
00000000000000000000000000000000000000000000000000000000000000000000000000000000000000000000000000000000000000000000000000000000000000000002
00000000000000000000000000000000000000000000000000000000000000000000000000000000000000000000000000000000000000000000000000000000000000000002
00000000000000000000000000000000000000000000000000000000000000000000000000000000000000000000000000000000000000000000000000000000000000000002
00000000000000000000000000000000000000000000000000000000000000000000000000000000000000000000000000000000000000000000000000000000000000000002
00000000000000000000000000000000000000000000000000000000000000000000000000000000000000000000000000000000000000000000000000000000000000000002
00000000000000000000000000000000000000000000000000000000000000000000000000000000000000000000000000000000000000000000000000000000000000000002
00000000004000400000000040000040000000000000000000004000000004000000000004000000000040000000000000000000400000000004000000004000000000000002
00000000000000000000000000000000000000044440000000000000000000000000000000000000000000000000000000000000000000000000000000000040000000000002
00000000000000000000000000000000000000000000000000000000000000000000000000000000000004000000000000000000000000000000000000000000000000000002
00000000000000000444444400000000000400000000400000000000000000000000040000000000000000000000000000000040000000000000000000000040000000000002
00000000000000000000000000000400000400000000000000000044400000000000000000000000000000000000000040000000000004004000400000000000000000000000
00000000000000000000000000000000000000000004000000000000000000000000000000000000000000000000400000000000004000000000000000000000000000000000
00000000000000000000000000000000000000000000000000000000000000000000000000000000000000000004000004004004000000000000000000000000000000000000
00000000000000000000000000000000000000000000000000000000000000000000000000000000000000000000000000000000000000000000000000000000000000000000
00000000000000000020200200020020020022222222000000222022000200020200200020020002000200020220000000000000000000000000000000000000000000000000
00000000000000200000000000000000000000000000000000000000000000000000000000000000000000000000000000000000000000000000000000000000000000000000
00000000000020000000000000000000000000000000000000000000000000000000000000000000000000000000000000000000000000000000000000000000000000000000
00000000200000000000000000000000000000000000000000000000000000000000000000000000000000000000000000000000000000000000000000000000000000000000
11111111111111111111331133113331113331131331111111133311331133113333111111333311331113333331133311333331113331133311331133113313331133113311