11111111111111111111111111111111111111111111111111111111111111111111111111111111111111111111111111111111111111111111111111111111111111111111
00000000000000000000000000000000000000000000000000000000000000000000000000000000000000000000000000000000000000000000000000000000000000000002
00000000000000000000000000000000000000000000000000000000000000000000000000000000000000000000000000000000000000000000000000000000000000000002
00000000000000000000000000000000000000000000000000000000000000000000000000000000000000000000000000000000000000000000000000000000000000000002
00000000000000000000000000000000000000000000000000000000000000000000000000000000000000000000000000000000000000000000000000000000000000000002
00000000000000000000000000000000000000000000000000000000000000000000000000000000000000000000000000000000000000000000000000000000000000000002
00000000000000000000000000000000000000000000000000000000000000000000000000000000000000000000000000000000000000000000000000000000000000000002
00000000000000000000000000000000000000000000000000000000000000000000000000000000000000000000000020000000000002002000200000000000000000000000
00000000000000000000000000000000000000000000000000000000000000000000000000000000000000000000200000000000002000000000002000000000000000000000
00000000000000000000000000000000000000000000000000000000000000000000000000000000000000000002000002002002000000000000000002000000020000020002
00000000000000000020000200020000020022222222000000022022000200020200200020020002000200020200000000000000000000000000000000000000000000000000
00000000000000020000000000000000000000000000000000000000000000000000000000000000000000000020000000000000000000000000000000000000000000000000
00000000000020000000000000000000000000000000000000000000000000000000000000000000000000000002000200000000200000020020002000002222222222222222
00000000020000000000000000000000000000000000000000000000000000000000000000000000000000000000000000000000000000000000000000000000000000000002
11111111113333333333333333333333333333333333333333333333333333333333333333333333333333333333333333333333333333333333333333333333333333333332